16 13
02 02 02 02 02 03 02 02 02 03 02 02 02 02 02 02 
02 02 02 02 02 03 02 02 02 03 02 02 02 02 02 02 
02 03 02 03 02 03 03 03 03 03 03 03 03 03 03 02 
02 03 02 03 02 02 02 02 02 03 02 02 02 02 02 02 
02 03 02 03 03 03 03 03 03 03 03 03 03 02 03 03 
02 03 02 02 02 02 02 02 02 02 02 02 03 02 03 02 
02 03 02 03 03 02 03 02 02 03 02 03 03 02 02 02 
02 03 02 02 03 02 03 02 02 03 02 03 03 02 03 02 
02 02 03 03 03 00 03 02 02 03 02 02 03 02 03 02 
02 02 03 03 02 03 03 02 02 03 03 02 03 02 03 02 
02 03 03 03 02 03 02 02 02 02 03 02 03 02 03 02 
02 03 03 03 02 03 02 02 02 02 03 02 03 03 03 02 
02 02 02 02 02 03 02 02 02 02 03 02 02 02 02 02 